[9,3,9,5,5,5,5,5,1,1,5,5,5,5,1,3,],
[10,10,12,3,9,5,5,7,10,8,5,5,5,3,10,10,],
[10,12,1,6,12,5,5,5,6,10,13,5,5,2,10,10,],
[10,9,2,9,5,1,5,5,5,4,5,5,5,6,10,10,],
[10,10,12,2,11,8,5,5,5,5,5,1,3,9,2,10,],
[10,12,3,8,2,8,5,1,5,5,3,10,10,14,10,10,],
[8,1,6,10,10,10,9,6,9,3,12,2,8,5,6,10,],
[10,12,3,10,10,10,10,9,2,12,3,10,12,3,9,2,],
[10,9,2,10,10,10,10,12,6,9,6,12,3,10,10,10,],
[10,10,10,12,6,10,12,5,3,12,3,9,6,10,10,10,],
[10,10,10,13,5,4,5,3,12,3,8,6,9,2,10,10,],
[10,10,8,5,3,9,3,12,3,12,2,9,6,10,10,10,],
[12,2,12,7,10,10,12,3,12,1,4,4,5,6,10,10,],
[9,2,13,5,2,12,3,12,3,12,5,5,5,5,2,10,],
[10,8,5,5,6,11,12,3,12,5,5,5,5,5,6,10,],
[14,12,5,5,5,4,5,4,5,5,5,5,5,5,5,6,],
