[11,9,5,5,5,5,3,13,7,9,5,5,5,5,5,3,],
[10,8,5,5,5,3,12,5,5,6,9,5,5,5,3,10,],
[10,10,9,5,7,12,5,3,9,5,6,13,5,3,8,2,],
[8,2,10,9,5,5,3,10,10,9,5,5,3,10,10,10,],
[10,10,14,10,15,11,10,8,2,10,11,15,10,14,8,2,],
[10,12,5,2,13,6,10,10,10,10,12,7,8,5,6,10,],
[12,3,15,12,1,5,6,12,6,8,5,5,6,15,9,6,],
[11,10,13,5,4,5,3,9,3,12,5,5,5,3,10,11,],
[14,10,13,1,5,5,6,12,4,5,5,5,5,6,10,14,],
[9,6,15,12,5,5,3,9,3,9,5,5,3,15,12,3,],
[10,9,5,3,13,3,10,10,10,10,9,7,8,5,3,10,],
[8,2,11,10,15,14,10,8,2,10,14,15,10,11,10,10,],
[10,10,10,12,5,1,6,10,10,12,1,5,6,10,8,2,],
[10,10,12,5,7,8,5,6,12,5,2,13,5,6,10,10,],
[10,8,5,5,5,6,9,5,5,3,12,5,5,5,6,10,],
[14,12,5,5,5,5,6,13,7,12,5,5,5,5,5,6,],
