[11,11,11,9,5,5,5,5,5,5,5,5,5,5,5,3,],
[10,10,8,2,9,5,5,5,5,5,5,5,5,5,5,2,],
[12,0,2,10,10,13,5,5,3,9,5,5,5,5,3,10,],
[9,6,10,10,10,9,5,5,0,6,9,5,5,5,2,10,],
[8,5,6,10,10,8,5,1,4,3,12,5,5,3,10,10,],
[8,5,5,6,10,10,9,4,7,14,9,5,5,6,10,10,],
[10,9,5,5,6,8,0,7,9,3,12,5,5,3,10,10,],
[10,8,5,5,5,6,14,9,2,8,5,5,5,6,14,14,],
[10,10,9,5,5,3,11,12,6,8,1,5,1,5,1,3,],
[10,12,4,5,3,10,8,5,5,6,12,1,0,5,2,10,],
[8,5,5,3,10,10,12,5,5,5,5,6,12,5,2,10,],
[8,5,3,10,10,10,9,5,5,5,5,5,5,5,4,2,],
[12,3,10,10,10,10,12,5,5,5,5,5,5,5,3,10,],
[9,0,2,10,10,12,5,5,5,5,5,5,5,5,6,14,],
[10,10,8,2,12,5,5,5,5,5,5,5,5,5,5,3,],
[14,14,14,12,5,5,5,5,5,5,5,5,5,5,5,6,],
