[9,5,5,5,5,5,1,5,5,5,1,5,5,5,5,3,],
[12,3,9,1,5,5,4,5,5,1,6,9,5,1,1,2,],
[9,2,10,12,1,5,5,1,5,4,5,2,9,2,10,10,],
[10,10,10,9,2,9,5,4,5,5,5,2,10,10,8,2,],
[8,6,12,2,12,2,9,5,5,5,3,12,2,8,2,10,],
[10,9,3,12,3,10,8,5,1,1,0,3,10,10,10,10,],
[10,10,12,3,10,10,8,5,6,10,10,10,8,6,10,10,],
[10,12,3,12,4,6,10,9,3,10,10,10,10,9,6,10,],
[8,3,10,9,5,5,2,12,4,6,8,2,10,10,9,6,],
[10,10,10,12,5,5,6,9,5,5,6,10,8,2,8,3,],
[10,10,8,1,5,5,3,12,5,5,1,2,10,10,10,10,],
[8,6,10,8,3,9,4,5,1,5,6,10,10,10,10,10,],
[10,9,6,10,8,4,1,5,4,5,5,6,8,2,10,10,],
[10,12,3,8,4,5,4,5,5,3,9,5,6,14,8,6,],
[8,3,12,6,9,5,5,5,3,12,6,9,5,5,4,3,],
[14,12,5,5,4,5,5,5,4,5,5,4,5,5,5,6,],
